10 100
BHEA->JEII
CEFF->BHBB
FCHG->BECD
CCBG->IFHG
BIJC->HJFE
DBCD->DEBB
DIHE->CHHJ
DBJI->GFAC
IGAC->EIGF
AJAA->GBDI
JDEE->GAGG
BIEJ->GDHI
ICJB->DFJI
EAHG->DGBF
ECAJ->HDHC
GABG->FHFE
BCAA->BEGA
HBHH->HHDD
FJJI->BICG
GADI->ABCF
AJEH->IDFB
CABG->EAGB
IJIE->BEDJ
IIAI->HHID
IDHB->AHDE
JGFB->AJJG
IDEI->EJJC
FFDD->DHED
IAII->AGIB
JIJH->CCIC
IJAH->IBFI
GBCE->CFIG
CGFD->JCEG
BICB->BJHG
CJFC->AADJ
BIBJ->FDCF
CFIG->HHCC
JEBJ->GJIC
FFEJ->BCFA
IDJD->JGHJ
JHGJ->DFHG
GFIC->FEEB
GBGD->DFFD
CICF->DGBI
GCBE->GCJB
FADG->EJCJ
DEEA->FJGD
ECII->HFIB
CFHE->EEEE
CJDA->HHIH
DADI->CFCA
DHCJ->HFDE
DCBB->DCFD
FBCC->CGEA
HADE->AAFD
BAGH->FAAE
FEJF->GEIC
BGID->BEIE
JCAH->AGAH
AFGH->DIEJ
CGFH->HEFH
JIDA->CCDG
HBFF->EACG
AGBB->BHDA
AEID->ABCJ
ADII->FHHA
IJDA->HEHI
DHBA->AIDE
FABE->FGCA
DFGG->GHGH
HBJB->GCHC
HGFB->DJJF
JCGF->DCEE
ECHJ->CDHD
BFHI->FIDC
EBBF->JFBA
GEFD->AIJB
DEHE->GDGF
CIBA->DBFF
CCBH->EICD
GDAD->FCIA
HCCF->JBAI
FAHJ->AFDE
BAEI->FJCF
EBDJ->FICH
JGBH->HBJA
DEBH->FDDC
EBCJ->AIHE
FGIA->HHED
BDGD->ABJA
ECJD->BEIC
AFFJ->DCIH
EIBE->DFFC
GIJC->JFJE
FAFI->IABD
CCCH->ADBD
DHAJ->FFID
HIDH->JDJB
ICIA->BIEI
GAJD->AAIH
